15 15
1_1 1_1 1_1 1_1 1_1 1_1 1_1 1_1 1_1 1_1 1_1 1_1 1_1 1_3 1_5
1_1 1_1 1_1 1_1 1_1 1_1 1_1 1_1 1_1 1_1 1_1 1_1 1_1 1_4 1_5
1_1 1_1 1_1 1_1 1_1 1_1 1_1 1_1 1_1 1_1 1_1 1_1 1_4 1_4 1_5
1_1 1_1 1_1 1_1 1_1 1_1 1_1 1_1 1_1 1_1 1_1 1_1 1_4 1_4 1_5
1_1 1_1 1_1 1_1 1_1 1_1 1_1 1_1 1_1 1_1 1_1 1_4 1_4 1_4 1_5
1_1 1_1 1_1 1_1 1_1 1_1 1_1 1_3 1_3 1_3 1_4 1_5 1_5 1_5 1_5
1_1 1_1 1_1 1_1 1_1 1_1 1_1 1_1 1_1 1_1 1_1 1_1 1_1 1_4 1_5
1_1 1_1 1_1 1_1 1_3 1_1 1_1 1_1 1_1 1_1 1_1 1_1 1_1 1_4 1_5
1_1 1_1 1_1 1_1 1_3 1_1 1_1 1_1 1_1 1_1 1_1 1_1 1_1 1_4 1_5
1_1 1_1 1_1 1_1 1_3 1_1 1_1 1_1 1_1 1_1 1_1 1_1 1_1 1_4 1_5
1_1 1_1 1_1 1_1 1_4 1_1 1_1 1_1 1_1 1_1 1_1 1_1 1_1 1_4 1_5
1_1 1_1 1_1 1_1 1_5 1_4 1_1 1_1 1_1 1_1 1_1 1_1 1_1 1_4 1_5
1_1 1_1 1_1 1_4 1_5 1_4 1_1 1_1 1_1 1_1 1_1 1_1 1_1 1_4 1_5
1_1 1_4 1_4 1_4 1_5 1_4 1_4 1_4 1_4 1_4 1_4 1_4 1_4 1_4 1_5
1_5 1_5 1_5 1_5 1_5 1_5 1_5 1_5 1_5 1_5 1_5 1_5 1_5 1_5 1_5
[[0,0],[0,1],[0,2],[1,0],[1,1],[1,2],[2,0],[2,1],[2,2]]
[[5,3,7,1],[7,3,4,1],[6,1,5,1],[5,1,6,1],[8,1,8,1]]